1   xxC   DEF
2   xxC   xEF
3   xBC   xxx
4   xBx   DEx
5   xxx   xxF
6   xBC   DEF
7   xxC   Dxx
8   ABC   DEF
9   ABC   DEF
10  ABC   DEF
11  ABC   DEF
12  xBC   DEx
13  xBC   DEF
14  ABC   DEF
15  ABC   xxx
16  AxC   DEF
17  ABC   DEF
18  xBC   DEF
19  ABC   DEF
20  ABC   DEF
21  ABC   DEF
22  xBC   DEx
23  ABC   xEF
24  ABx   DEF
25  ABC   DEx
26  xBC   DEx